11111111111111
100011100000C1
10P01C00111101
1000000011C101
111110B0000001
10000000111101
1C1110001C0001
10000011111111
11111011000001
1C000000011101
110C0111C111E1
11111111111111
