1111111111111
100000000B001
1000000000001
1000P00000001
10000000C0001
11100C0000001
1E10000000001
1111111111111
