11111111111111111111111111111111111111111111111111111
100000000000000000000000000000000000000000000C000C001
10000000000000000000000000000000000000000000000100001
1000000000000000000000000000000000000000000000010C001
10000000000000000000000000000000000000000000000100001
1000000000000000000000000000000000000000000000010C001
10000000000000000000000000000000000000000000000100001
10111110111111111111111111111111111111111111111111101
100C1000000000000000000000000000000000000000000000001
100C1000000000000000000000000000000000000000000000001
100E1000000000000000000000000000000000000000000000001
10111000000000000000000000000000000000000000000000001
10100000000000000000000000000000000000000000000000001
10100000000000000000000000000000000000000000000000001
10100000000000000000000000000000000000000000000000001
10100000000000000000000000000000000000000000000000001
101111111011111010101111111110111110111110101011101C1
1010C0C01010C0101010C0C0C0C01000100010001010100010101
101011101010101010111111111011101011101011101110101C1
10001000100010000010C0C0C0C0C0C01000001000000000100P1
11111111111111111111111111111111111111111111111111111
