1111111111111
1B0C10000C0C1
1000101011111
1C10P01000001
1111000000001
10B00010B00E1
1110011011011
1B00000000001
1100CC00000C1
10C0C0BBB00C1
1111111111111
