1111111111111
1B0C10000C0C1
1000101011111
1C10P01000001
1111000000001
10B00010B00E1
1110011011C11
1BC0000000001
1100CC00000C1
1BC0C0BBBC0C1
1111111111111
